"filename", "language", "CMake", "cpp", "comment", "blank", "total"
"/home/pello/PySysLink/CMakeLists.txt", "CMake", 62, 0, 0, 25, 87
"/home/pello/PySysLink/Tests/CMakeLists.txt", "CMake", 29, 0, 0, 8, 37
"/home/pello/PySysLink/Tests/test_main.cpp", "cpp", 0, 33, 0, 18, 51
"/home/pello/PySysLink/build/_deps/spdlog-src/example/CMakeLists.txt", "CMake", 19, 0, 0, 5, 24
"/home/pello/PySysLink/build/_deps/spdlog-src/example/example.cpp", "cpp", 0, 349, 0, 52, 401
"/home/pello/PySysLink/src/BlockEvents/BlockEvent.h", "cpp", 0, 14, 0, 7, 21
"/home/pello/PySysLink/src/BlockEvents/ValueUpdateBlockEvent.h", "cpp", 0, 18, 0, 4, 22
"/home/pello/PySysLink/src/BlockEventsHandler.cpp", "cpp", 0, 18, 0, 6, 24
"/home/pello/PySysLink/src/BlockEventsHandler.h", "cpp", 0, 15, 0, 6, 21
"/home/pello/PySysLink/src/BlockTypeSupportPlugingLoader.cpp", "cpp", 0, 58, 0, 13, 71
"/home/pello/PySysLink/src/BlockTypeSupportPlugingLoader.h", "cpp", 0, 17, 0, 8, 25
"/home/pello/PySysLink/src/CMakeLists.txt", "CMake", 49, 0, 0, 11, 60
"/home/pello/PySysLink/src/ConfigurationValue.h", "cpp", 0, 55, 0, 8, 63
"/home/pello/PySysLink/src/ContinuousState.cpp", "cpp", 0, 20, 0, 2, 22
"/home/pello/PySysLink/src/ContinuousState.h", "cpp", 0, 16, 0, 4, 20
"/home/pello/PySysLink/src/IBlockEventsHandler.h", "cpp", 0, 14, 0, 7, 21
"/home/pello/PySysLink/src/IBlockFactory.h", "cpp", 0, 18, 0, 4, 22
"/home/pello/PySysLink/src/ISimulationBlock.cpp", "cpp", 0, 81, 0, 14, 95
"/home/pello/PySysLink/src/ISimulationBlock.h", "cpp", 0, 40, 0, 12, 52
"/home/pello/PySysLink/src/ISimulationBlockWithContinuousStates.h", "cpp", 0, 15, 0, 6, 21
"/home/pello/PySysLink/src/ModelParser.cpp", "cpp", 0, 172, 0, 21, 193
"/home/pello/PySysLink/src/ModelParser.h", "cpp", 0, 21, 0, 5, 26
"/home/pello/PySysLink/src/PortLink.cpp", "cpp", 0, 14, 0, 4, 18
"/home/pello/PySysLink/src/PortLink.h", "cpp", 0, 26, 0, 6, 32
"/home/pello/PySysLink/src/PortsAndSignalValues/InputPort.cpp", "cpp", 0, 13, 0, 4, 17
"/home/pello/PySysLink/src/PortsAndSignalValues/InputPort.h", "cpp", 0, 14, 0, 4, 18
"/home/pello/PySysLink/src/PortsAndSignalValues/OutputPort.cpp", "cpp", 0, 7, 0, 3, 10
"/home/pello/PySysLink/src/PortsAndSignalValues/OutputPort.h", "cpp", 0, 11, 0, 5, 16
"/home/pello/PySysLink/src/PortsAndSignalValues/Port.cpp", "cpp", 0, 34, 0, 6, 40
"/home/pello/PySysLink/src/PortsAndSignalValues/Port.h", "cpp", 0, 19, 0, 9, 28
"/home/pello/PySysLink/src/PortsAndSignalValues/SignalValue.h", "cpp", 0, 33, 0, 10, 43
"/home/pello/PySysLink/src/PortsAndSignalValues/UnknownTypeSignalValue.h", "cpp", 0, 24, 0, 12, 36
"/home/pello/PySysLink/src/SampleTime.cpp", "cpp", 0, 100, 0, 8, 108
"/home/pello/PySysLink/src/SampleTime.h", "cpp", 0, 39, 0, 7, 46
"/home/pello/PySysLink/src/SimulationManager.cpp", "cpp", 0, 108, 0, 16, 124
"/home/pello/PySysLink/src/SimulationManager.h", "cpp", 0, 19, 0, 9, 28
"/home/pello/PySysLink/src/SimulationModel.cpp", "cpp", 0, 276, 0, 41, 317
"/home/pello/PySysLink/src/SimulationModel.h", "cpp", 0, 31, 0, 12, 43
"/home/pello/PySysLink/src/SimulationOptions.h", "cpp", 0, 15, 0, 6, 21
"/home/pello/PySysLink/src/SpdlogManager.cpp", "cpp", 0, 37, 0, 5, 42
"/home/pello/PySysLink/src/SpdlogManager.h", "cpp", 0, 21, 0, 5, 26
"Total", "-", 159, 1815, 0, 418, 2392